#####################################
#......$............................#
#....O..............................#
#$..................................#
#...................................#
#...................................#
#................X..................#
#...................................#
#...................................#
#..........B........................#
#####..##....................O......#
#.......#...........................#
#....@..#...........................#
#.......#...........................#
#####################################
